0000000000000000000000000000
0000000000000000000000000000
0000000000000000000000000000
1111111111111111111111111111
1dddddddddddd11dddddddddddd1
1d1111d11111d11d11111d1111d1
1D1111d11111d11d11111d1111D1
1d1111d11111d11d11111d1111d1
1dddddddddddddddddddddddddd1
1d1111d11d11111111d11d1111d1
1d1111d11d11111111d11d1111d1
1dddddd11dddd11dddd11dddddd1
111111d11111011011111d111111
000001d11111011011111d100000
000001d110000rr000011d100000
000001d11011111111011d100000
111111d1101bbppoo1011d111111
000000d0001bbppoo1000d000000
111111d1101bbppoo1011d111111
000001d11011111111011d100000
000001d11000000000011d100000
000001d11011111111011d100000
111111d11011111111011d111111
1dddddddddddd11dddddddddddd1
1d1111d11111d11d11111d1111d1
1d1111d11111d11d11111d1111d1
1Ddd11dddddddPPddddddd11ddD1
111d11d11d11111111d11d11d111
111d11d11d11111111d11d11d111
1dddddd11dddd11dddd11dddddd1
1d1111111111d11d1111111111d1
1d1111111111d11d1111111111d1
1dddddddddddddddddddddddddd1
1111111111111111111111111111
0000000000000000000000000000
0000000000000000000000000000
